..........
..........
.@......@.
####..####
..........
..........
..........
..@....@..
##########
.