..........
..........
..........
####..####
..........
..........
..........
..........
##########
##########