..........
##......##
..........
..........
..........
..######..
..........
..........
..........
##.....##