.@......@.
##......##
..........
..........
....@@....
..######..
..........
..........
.@......@.
##......##